10
A.G.G.-.-.-.-.-.G.-
-.-.-.-.P.-.-.P.-.W
G.-.-.-.-.-.-.-.-.-
-.W.P.-.-.G.-.G.-.G
-.-.G.-.-.-.G.-.-.-
-.G.-.-.-.-.W.-.G.-
G.-.-.P.-.-.-.-.G.-
P.G.-.-.-.G.-.-.W.-
-.-.-.P.-.W.-.-.G.-
-.G.-.-.-.-.-.G.G.-