10
G.W.W.W.G.W.W.W.W.W
W.W.W.W.W.W.W.W.W.W
W.W.P.P.P.P.P.W.W.W
W.W.P.W.W.W.P.W.W.W
W.W.P.W.G.W.P.W.W.G
G.W.P.G.W.G.P.W.W.W
W.W.W.W.W.W.W.W.W.W
W.W.W.W.A.W.W.W.W.W
G.W.W.W.G.W.W.W.W.G
W.W.W.W.G.W.W.W.W.W