10
G.G.-.-.P.-.-.-.-.-
G.G.-.-.P.-.-.-.G.-
-.-.W.-.P.-.-.-.-.-
-.P.-.-.-.-.-.-.-.-
P.-.-.-.-.-.-.-.-.-
-.-.-.-.-.-.-.-.-.-
-.-.W.-.-.-.P.-.-.-
-.W.A.-.-.-.-.G.-.-
-.-.W.-.-.-.-.-.P.-
-.-.-.-.-.-.-.-.-.-