10
G.G.-.-.-.P.-.-.-.G
-.-.-.-.G.-.-.-.-.-
-.G.-.-.-.W.-.-.-.-
G.-.-.-.-.-.-.-.-.-
-.P.-.-.-.-.-.A.-.-
-.-.P.-.-.-.-.-.-.-
-.-.-.-.-.-.-.-.-.-
G.-.-.G.GW.-.-.P.-.-
-.W.-.-.-.-.-.-.-.-
G.-.-.-.-.-.-.-.-.G

