10
G.G.-.-.P.-.-.-.-.-
-.-.-.-.P.W.-.-.G.-
-.-.W.-.P.-.-.-.-.A
-.P.-.-.-.-.-.-.-.-
P.-.-.-.-.-.-.-.-.-
-.-.-.-.G.-.-.-.-.-
-.-.-.-.-.-.P.-.-.-
-.-.-.-.-.-.-.G.-.-
G.-.-.-.-.-.-.-.P.-
-.-.-.-.-.G.-.-.-.-
